{
    "1": "CP1",
    "2": "C3",
    "3": "FC1",
    "4": "Cz",
    "5": "FC2",
    "6": "C4",
    "7": "CP2",
    "8": "Fpz",
    "9": "FC5",
    "10": "CP5",
    "11": "F3",
    "12": "O1",
    "13": "O2",
    "14": "FC4",
    "15": "F4",
    "16": "CP6"
}
