{
    "1": "FC5",
    "2": "C3",
    "3": "FC1",
    "4": "CP5",
    "5": "F3",
    "6": "C4",
    "7": "CP2",
    "8": "Fpz",
    "9": "CP1",
    "10": "Cz",
    "11": "FC2",
    "12": "O1",
    "13": "O2",
    "14": "FC4",
    "15": "F4",
    "16": "CP6"
}
